  ****             *            
     *             *            
     *             *            
                   *            
               *****************
               *                
               *                
        *****  *                
        *   *  ******           
        *   *       *           
        *  **********           
        *   *         *         
        *             *         
        *****************       
                        *******0